################
#     # #      #
#              #
#              #
#   @          #
#              
#              #
#              #
#   xxxxxxx    #
#       XXX    #
#              #
#              #
#              #
#################